{
  "TileSize": 32,
  "Width": 100,
  "Height": 50,
  "Effect": {
    "None": 0,
    "Start": 1,
    "End": 2,
    "Spawn": 3
  },
  "Palette": {
    " ": {
      "TextureIndex": 0,
      "AutoTile": false,
      "Solid": false,
      "Effect": 0
    },
    "#": {
      "TextureIndex": 4,
      "AutoTile": true,
      "Solid": true,
      "Effect": 0
    },
    "X": {
      "TextureIndex": 9,
      "AutoTile": true,
      "Solid": true,
      "Effect": 0
    },
    "+": {
      "TextureIndex": 52,
      "AutoTile": true,
      "Solid": true,
      "Effect": 0
    },
    "=": {
      "TextureIndex": 57,
      "AutoTile": true,
      "Solid": true,
      "Effect": 0
    },
    ":": {
      "TextureIndex": 100,
      "AutoTile": true,
      "Solid": true,
      "Effect": 0
    },
    "O": {
      "TextureIndex": 148,
      "AutoTile": true,
      "Solid": true,
      "Effect": 0
    },
    "-": {
      "TextureIndex": 105,
      "AutoTile": true,
      "Solid": true,
      "Effect": 0
    },
    "[": {
      "TextureIndex": 78,
      "AutoTile": false,
      "Solid": false,
      "Effect": 1
    },
    "]": {
      "TextureIndex": 46,
      "AutoTile": false,
      "Solid": false,
      "Effect": 2
    },
    "|": {
      "TextureIndex": 14,
      "AutoTile": false,
      "Solid": false,
      "Effect": 3
    }
  },
  "Data": [
    "                                                                                                    ",
    "                                                                                                    ",
    "                                                                                                    ",
    "                                                                                                    ",
    "                                                                                                    ",
    "                                                                                                    ",
    "                                                                                                    ",
    "                                                                                      ]             ",
    "                                                                     +++++++++++++++++++++++++   +++",
    "                                                             [       +++++++++++++++            ++++",
    "                                                  ---X X X X-----    ++++++++++++++            +++++",
    "                                                  ---X X X X-----+   +++++++++++++   +++++++++++++++",
    "                                                  ---X X X X-----+   ++++++++++++   ++++++++++++++++",
    "                                                  ---X X X X-----+   +++++++++++   +++++++++++++++++",
    "                                                  ---X X X X-----+   ++++++++++   ++++++++++++++++++",
    "                                                  ---X X X X-----+   +++++++++   +++++++++++++++++++",
    "                                                  ---X X X X-----+   ++++++++   ++++++++++++++++++++",
    "                                                  ---X X X XXXX+++   +++++++   +++++++++++++++++++++",
    "   -------------------                            ---X X X           +++      ++++++++++++++++++++++",
    "   -------------------::::::::::::::::::::::::::::XXXX X X XXXX::::::+++     +++++++++++++++++++++++",
    "   --------                                                                +++++++++++++++++++++++++",
    "   -------   ---------::::::::::::::::::::::::::::XXXX X X XXXX::::::++++   ++++++++++++++++++++++++",
    "   ------   ----------                               X X X X         +++++       +++++++++++++++++++",
    "   -----   -----------                                               ++++++      +++++++++++++++++++",
    "   ----   ------------                                                      +  +++++++++++++++++++++",
    "   --    ---                        ##  ##########  #  # #  #  ######+++++++++  ++++++++++++++++++++",
    "   ----   --                           ###########  #  # #  #  ######++++++++++           ++        ",
    "   --    ---    [              XX XXX############# ## ## ## #[ ######++++++++++++++++++++    +++++++",
    "      --    |  +++           XXXX   ############## ## ## ## ##                          ++  ++++++++",
    "   ---------###+++###  #  ########   ############# ## ## ## ########++++++++++++++++++     +++++++++",
    "#   ################# ### #########   ############ ## ## ## #########++++++++++++++++++   ++++++++++",
    "==   ===============================                                                    +    +++++++",
    "===                                                           =======+++++++++++++++++++++++++++++++",
    "====   =====================================================   ======+++++++++++++++++++++++++++++++",
    "=====   =============================OOOOOOO=================   ====================================",
    "======                    ===========O     OOOOOO=============   ===================================",
    "=======                    ==========O  ]       O==============   ==================================",
    "=========================   =========O OOO OO  O================   =================================",
    "==========================   ========O        O==================   ================================",
    "===========================   =======O   X OOOO===================   ===============================",
    "============================   ======O X   O==========                ==============================",
    "=============================     O OO   X OO O                        =============================",
    "==============================     OOO X   OOO              O OO      OO============================",
    "===============================     O    X  O        O     OOOOOO   OOOOO===========================",
    "================================       X          OOOOO=============================================",
    "====================================O=======O=======================================================",
    "====================================================================================================",
    "====================================================================================================",
    "====================================================================================================",
    "===================================================================================================="
  ]
}